10 10
1 2
6 6
0 1 3 4 0 2 0 1 2 1
0 0 1 0 3 4 2 1 3 0
4 2 2 0 5 3 2 2 5 1
2 0 1 3 0 2 2 0 1 4
1 0 0 0 0 1 4 5 1 1
4 0 2 1 1 0 0 0 2 0
2 1 4 5 2 2 1 2 5 0
0 1 0 0 0 0 0 0 1 0
0 1 1 1 1 0 0 0 3 0
1 0 0 0 1 1 1 1 4 0